###############
#.#.....#E....#
#.#.###.#####.#
#.#...#.......#
#.###.####.####
#.......##....#
#.#####.#####.#
#....#S.#.....#
####.####.#####
#.......#.....#
#.#####...###.#
#.#.....###...#
#.#.#.#######.#
#...#...#.....#
###############
