###############
#........E....#
#.............#
#.............#
#.............#
#.............#
#.............#
#.....S.......#
#.............#
#.............#
#.............#
#.............#
#.............#
#.............#
###############
